Attack - Атак(-увати)
Apply - Наносить
Block - Блок
Button - ґудзик
Boss - Бос
Character - Герой
Chest - скриня
Click - Клац(-ніть)
Сolo(u)rless - Безбарвну
Confused - нестямний(-им)
Curse - прокляття
Damage - шкода
Deck - Колода
Deal - наносити / також наноситься
Dexterity - Спритність
Dig - (від)Копати
Discard - Усунути
Draw - тасують(-ється)
Drop - залишають по собі
Elite - Пан
Elites - Пани
Exhaust - виснажені(-а/-е)
Heal - зцілює(-тесь)
HP - ОЗ
Intents - Наміри
Ironclad - Броненосець
Negate - анулювати (Анулюєте)
Map - мапа (НЕ карта)
Merchant - Торговець
Obtain - отримуєте
Poison - Отрута(-у)
Potion - зілля
Power - Снага
Relic - Мощь
Remove - Усунути
Rest - (відпочиваєте у) Таборі
Rest Sites - Табори
Score - Рахунок
Shop - Крамниці
Shuffle - тасують(-ється)
Skill - Вміння
Status - Статус
Strength - Міць
Spire - Вежа
Spireblight - забруднення вежею / чуми (???)
Take (damage) - отримуєш
Transform - Перетвори
Treasure - Скарби 
Treasure Rooms - Скарбниця
The Silent - Тінь
Turn - Хід (ходу)
Upgrade (card) - Поліпшити (карту)
Vulnerable - Уразливий
Weak - Слабкість
Weakened - Ослаблений(-ити)
Wounds - Рани
Whenever you (deal) - Щоразу Ви (наносите)
You - Ви (НЕ ти)
You can no longer become (Weakened) - Вас неможливо (Ослабити)


Акт 1 - Exordium - Ворота
Акт 2 - The City - Місто
Акт 3 - The Beyond - Далина


Cards:

Shiv - Цизорик
Strike - Удар
Defend - Захист

Entities:

Snecko - Зміяко


